111111111111111111111111111111111111
1P10001000C1100011C1C1C100CCC00110C1
10111C10111C111100000C01C0C0C0001101
1000001C000C0001100011000CC0C0000101
11101010111011011000C00000C000010101
1C00100000011C011C0000C0CCC00EC000C1
100010101010100C11C00011100001010101
1100101010101C110000000CC0C101010101
1C100C000C0001001100C00CCC1C01000001
1000101010100100011C1100001101010101
10C110100CCC000CC0C000CC0110C0110111
111111111111111111111111111111111111
