1111111111
1P00000011
111111C001
1CECCCC1C1
1111111111
