11111111111111
1P000000000101
10000000000001
10000000000001
11100000C00111
1CC0000000E0C1
11111111111111
